%%%%%%%%%%%%%%
%G      ..P..%
%%%%%%%%%%%%%%
